7
7
XXXXXXX
XSX   X
X XX XX
X    XX
XX XXXX
X    FX
XXXXXXX